Chr Marker Haldane
1 M0001 1
1 M0002 1
1 M0003 1
1 M0004 1
1 M0005 1
1 M0006 1
1 M0007 1
1 M0008 1
1 M0009 1
1 M0010 1
