# $Id: PedCount.pl 2408 2009-11-13 17:29:39Z whv001 $
CHR MARKER KOSAMBI
1 M0001 1
1 M0002 1
1 M0003 1
1 M0004 1
1 M0005 1
1 M0006 1
1 M0007 1
1 M0008 1
1 M0009 1
1 M0010 1
1 M0011 1
1 M0012 1
1 M0013 1
1 M0014 1
1 M0015 1
1 M0016 1
1 M0017 1
1 M0018 1
1 M0019 1
